#########################
#.......................#
#..#.....#..#........#..#
#...#...#...#........#..#
#....#@#....#........#..#
#.....#.....#........#..#
#.....#.....#...........#
#.....#.....#######..#..#
#.......................#
#...#.....#....#####....#
#...#....#....#.....#...#
#...#...#.....#.........#
#...####.......#####....#
#...#...#...........#...#
#...#....#....#.....#...#
#...#.....#....#####....#
#.......................#
#########################