###################
#........#........#
#.##.###.#.###.##.#
#.................#
#.##.#.#####.#.##.#
#....#...#...#....#
####.### # ###.####
   #.#       #.#
####.# ## ## #.####
    .  #!!!#  .
####.# ##### #.####
   #.#       #.#
####.# ##### #.####
#........#........#
#.##.###.#.###.##.#
#..#.....@.....#..#
##.#.#.#####.#.#.##
#....#...#...#....#
#.######.#.######.#
#.................#
###################