###########
#.........#
#.#.....#.#
#..#...#..#
#...#@#...#
#....#....#
#....#....#
#....#....#
#.........#
#.# #######
#.# #!!!# #
#.# ## ## #
#.#       #
#.#.#####.#
#.#.......#
#.#######.#
#.........#
###########