###################
#.................#
#.##.#.#####.#.##.#
#....#.#...#.#....#
#.####.#.#.#.####.#
#........#........#
####.#.#####.#.####
   #.#       #.#
## #.# ## ## #.# ##
#....  #!!!#  ....#
#.##.# ##### #.##.#
#....#       #....#
###.#### # ####.###
#........#........#
#.#.###.###.###.#.#
#.#......@......#.#
#.###.#.###.#.###.#
#.#...#..#..#...#.#
#.#.####.#.####.#.#
#.................#
###################