##############
#............#
#.####.#####.#
#.#  #.#   #.#
#.####.#####.#
#............#
##############